Lobber,Saboteur,Standard,Tank,Loops
0,0,8,0,1
0,0,12,0,1
0,0,16,0,1
0,0,8,1,1
0,0,4,1,2
0,1,7,0,1
0,1,5,0,2
0,3,5,0,2
0,4,4,1,1
0,3,3,1,2
1,1,6,0,1
2,2,2,0,2
1,1,2,0,4
3,3,3,1,1
3,3,2,1,2