Lobber,Saboteur,Standard,Tank,Loops,NextStep
0,0,8,0,1,N
0,0,12,0,1,N
0,0,16,0,1,B
0,0,8,1,1,N
0,0,4,1,2,L
0,1,7,0,1,N
0,1,5,0,2,N
0,3,5,0,2,B
0,4,4,1,1,N
0,3,3,1,2,L
1,1,6,0,1,N
2,2,2,0,2,N
1,1,2,0,4,B
3,3,3,1,1,N
3,3,2,1,2,L